######a####
#+#..#@####
#a#.aaaaaa#
#a#.a######
#a.#aaaaa.#
#a..#.##a.#
#a...#aaa.#
#a...#a...#
#aaaaaa...#
###########