######
#+aaa#
####@#
####a#
######